###################################################
###################################################
###################################################
###################################################
###################################################
#####p                #                 #     #####
#####                 #                 #     #####
#####                 #                 #     #####
#####                 #                 #     #####
#####                 #                 #     #####
#################     #     #######     #     #####
#####     #           #     #     #     #     #####
#####     #           #     #     #     #     #####
#####     #           #     #     #     #     #####
#####     #           #     #     #     #     #####
#####     #           #     #     #     #     #####
#####     #     #######     #     #     #     #####
#####     #           #     #     #           #####
#####     #           #     #     #           #####
#####     #           #     #     #           #####
#####     #           #     #     #           #####
#####     #           #     #     #           #####
#####     #######     #     #     #######     #####
#####           #     #     #                 #####
#####           #     #     #                 #####
#####           #     #     #                 #####
#####           #     #     #                 #####
#####           #     #     #                 #####
#####     #     #     #     #######     ###########
#####     #     #     #           #     #     #####
#####     #     #     #           #     #     #####
#####     #     #     #           #     #     #####
#####     #     #     #           #     #     #####
#####     #     #     #           #     #     #####
#####     #     #     #######     #     #     #####
#####     #                       #          g#####
#####     #                       #           #####
#####     #                       #           #####
#####     #                       #           #####
#####     #                       #           #####
###################################################
