###################################################
###################################################
###################################################
###################################################
###################################################
#####p    #                       #           #####
#####     #                       #           #####
#####     #                       #           #####
#####     #                       #           #####
#####     #                       #           #####
#####     #############     #     #     #     #####
#####                 #     #           #     #####
#####                 #     #           #     #####
#####                 #     #           #     #####
#####                 #     #           #     #####
#####                 #     #           #     #####
#################     #     #############     #####
#####           #     #     #                 #####
#####           #     #     #                 #####
#####           #     #     #                 #####
#####           #     #     #                 #####
#####           #     #     #                 #####
###########     #     #######     #################
#####           #           #                 #####
#####           #           #                 #####
#####           #           #                 #####
#####           #           #                 #####
#####           #           #                 #####
#####     #     #######     #     #######     #####
#####     #           #     #     #           #####
#####     #           #     #     #           #####
#####     #           #     #     #           #####
#####     #           #     #     #           #####
#####     #           #     #     #           #####
#####     #############     #######     #     #####
#####                                   #    g#####
#####                                   #     #####
#####                                   #     #####
#####                                   #     #####
#####                                   #     #####
###################################################
