###############################
###############################
###############################
###p      #       #           #
###       #       #           #
###       #       #           #
#######   #####   #   #   #####
###   #       #       #       #
###   #       #       #       #
###   #       #       #       #
###   #####   #############   #
###       #       #       #   #
###       #       #       #   #
###       #       #       #   #
#######   #####   #   #   #   #
###           #   #   #   #   #
###           #   #   #   #   #
###           #   #   #   #   #
###   #####   #   #   #   #   #
###       #   #       #   #   #
###       #   #       #   #   #
###       #   #       #   #   #
###   #   #############   #   #
###   #   #       #       #   #
###   #   #       #       #   #
###   #   #       #       #   #
###   #   #   #   #   #####   #
###   #       #            g  #
###   #       #               #
###   #       #               #
###############################
